1111111
1E0C0P1
1111111
1000001
1111111