1111111111111111111111
1P10000110C11000CC0001
1000000CC00000000C0001
1000001010000000111111
10111001C00000000000C1
101C101C10000000111111
1010100000CCC000000001
1000000000000000000001
10C001100000000C000001
10C00110000000C1C00011
10000000CC00000C000XE1
1111111111111111111111