1111111111111111111111
1P10000110C11000CC0001
1000000CC00000000C0001
1000001010000X00111111
10111001C000X0000000C1
101C101C10000000111111
1010100000CCCX00000001
10000000000000E0000001
10C00110000XX00C000001
10C0011000000XC1C00001
10000000CC00XX0C000001
1111111111111111111111