1111111111111111111111
1P10000110C11000CC0001
1000X00CC00000000C0001
1000001010000000XXXXX1
10111001C00000000000C1
101C101CX0000000XXXXX1
101010000XCCC0X0000001
1000X000000000E0000001
10C001100000000C000001
10C001100X0000C1C00001
10000000CC00X00C000001
1111111111111111111111