1111111111111111111111
10P0E0X111111111111111
1111111111111111111111