11111111111111111111111111111111111111111111111111111111111111111111111111
100000000P0000000000C000000000000000C00000000000000000E0000000000000000001
11111111111111111111111111111111111111111111111111111111111111111111111111