1111111
1000001
10EC011
1111001
101C001
101CC01
1C00P01
1111111