1111111111111111111111
10P0E01111111111111111
1111111111111111111111